############B###############
## ### #####              ##
## ### #####  #### ### ##  #
#                  ### ### #
# ### ################ ### #
# ### #####            ### #
# ###       # #### ## ###  #
# #### #### #  #### # #### #
# ##    ### # #            #
#  ### #### # ######## ### #
## ##   ###       #### ### #
## #### #### #### #### ### #
## #### #### #### #### ### #
##                         #
###A########################
